{
    "test_map" : {
        "name" : "Test Map",
        "size" : 10,
        "map" : 
        [
            [1,1,1,1,1,1,1,1,1,1,1],
            [1,0,0,0,0,1,0,0,0,0,1],
            [1,0,0,0,0,1,0,0,0,0,1],
            [1,0,0,0,0,1,1,2,1,1,1],
            [1,0,0,0,0,1,0,0,0,0,1],
            [1,0,0,0,0,1,0,0,0,0,1],
            [1,1,2,1,1,1,0,0,0,0,1],
            [1,0,0,0,0,1,0,0,0,0,1],
            [1,0,0,0,0,2,0,0,0,0,1],
            [1,0,0,0,0,1,0,0,0,0,1],
            [1,1,1,1,1,1,1,1,1,1,1]
        ],
        "npcs" :
        [
            [0,0,0,0,0,0,0,0,0,0],
            [0,0,0,0,0,0,0,0,1,0],
            [0,0,0,0,0,0,0,0,0,0],
            [0,0,0,0,0,0,0,0,0,0],
            [0,0,0,0,0,0,0,0,0,0],
            [0,0,0,0,0,0,0,0,0,0],
            [0,0,0,0,0,0,0,0,0,0],
            [0,0,0,0,0,0,0,0,0,0],
            [0,0,1,0,0,0,0,0,1,0],
            [0,0,0,0,0,0,0,0,0,0]
        ],
        "items"  :
        [
            [0,0,0,0,0,0,0,0,0,0],
            [0,0,0,0,0,0,0,0,0,0],
            [0,0,0,1,0,0,0,0,0,0],
            [0,0,0,0,0,0,0,0,0,0],
            [0,0,0,0,0,0,0,0,0,0],
            [0,0,0,0,0,0,0,0,0,0],
            [0,0,0,0,0,0,1,2,0,0],
            [0,0,0,0,0,0,0,0,0,0],
            [0,0,0,0,0,0,0,0,0,0],
            [0,0,0,0,0,0,0,0,0,0]
        ]
    }
}